0,0,0,0,0,1,9,9,9,9,9,9,9,1,1,9,9,9,9,9,1,0,1,1,1,0,0,0,1,1,1,1,1,1,1,0,0,0,0,0
0,9,1,9,9,9,1,1,1,1,1,1,1,1,1,9,1,9,9,9,9,0,0,1,1,1,1,0,1,1,1,1,1,1,1,1,1,1,0,0
9,0,9,9,1,1,1,1,1,1,1,1,1,1,1,1,1,9,9,9,9,1,1,1,1,1,1,9,9,9,9,0,1,1,1,2,2,2,1,1
9,9,9,1,1,1,1,1,1,1,6,8,8,8,9,1,1,1,1,1,1,1,1,1,1,9,9,0,5,5,9,9,9,1,2,2,2,2,2,1
9,1,1,1,1,1,1,1,1,1,1,8,8,8,9,9,1,1,1,1,1,1,1,0,1,8,8,5,5,5,5,5,9,1,2,2,2,2,2,1
0,1,1,1,1,1,1,1,1,1,1,8,3,3,3,3,3,3,3,3,3,3,3,3,8,8,5,5,5,6,5,5,9,9,2,2,2,2,2,2
9,1,1,1,1,2,2,1,1,1,1,9,3,1,1,1,0,2,2,2,1,1,1,3,8,8,5,6,5,5,5,5,5,9,1,2,2,2,2,2
9,1,1,1,1,2,1,1,1,9,0,1,3,0,0,0,0,2,2,2,2,1,2,3,3,3,5,5,5,6,5,5,9,9,1,2,2,2,2,2
0,1,1,1,1,2,1,1,1,6,0,0,3,0,2,0,0,2,2,2,2,2,2,9,0,3,3,3,5,5,5,5,8,8,1,1,2,2,2,2
0,1,1,1,1,2,1,1,1,0,0,0,3,2,2,2,2,2,2,2,2,2,2,2,2,0,1,3,3,3,8,8,8,8,1,1,2,2,2,2
2,1,1,1,1,2,2,2,2,0,2,2,3,2,2,9,9,2,2,2,2,2,2,2,2,0,0,1,1,3,3,3,1,1,1,1,2,2,2,2
2,2,1,1,1,1,2,2,2,2,2,2,3,9,9,9,9,9,9,2,2,2,2,2,2,0,0,0,0,1,1,3,1,0,2,2,2,2,2,1
1,2,2,1,1,1,2,2,2,2,2,1,3,9,1,5,1,9,9,1,1,2,2,2,2,2,0,0,0,1,1,3,1,1,1,2,2,2,1,1
1,1,2,2,2,2,2,2,2,2,1,1,3,9,5,6,5,5,9,9,1,1,2,2,2,2,0,0,0,0,1,3,1,1,0,1,9,9,9,1
1,1,1,1,1,2,2,2,2,2,1,9,3,9,5,5,5,6,5,5,0,1,1,2,2,2,2,2,2,2,1,3,1,1,0,0,9,9,9,1
0,1,1,1,1,2,2,2,2,2,1,9,3,8,9,5,5,5,5,9,0,1,1,2,2,2,2,2,2,2,5,3,1,1,0,0,9,9,1,1
1,1,1,1,1,1,1,2,2,2,2,2,3,2,2,2,2,2,2,1,1,1,2,2,2,2,2,2,2,2,5,3,1,1,0,0,9,9,1,1
1,1,1,1,1,1,0,0,2,2,2,2,3,2,2,2,2,2,2,2,2,2,2,2,2,2,2,2,5,5,5,3,1,1,1,0,9,9,9,1
1,0,5,5,5,5,5,5,5,5,5,2,3,2,2,2,2,2,2,2,2,2,2,2,2,1,1,5,5,6,1,3,1,0,1,9,9,9,9,9
1,0,5,5,6,5,6,5,5,6,5,2,3,0,2,2,2,2,2,2,2,2,2,2,1,1,1,5,8,8,3,3,1,0,1,1,9,9,9,9
1,5,6,5,5,5,5,5,5,5,5,8,3,5,5,6,1,1,1,2,2,2,2,2,1,1,1,2,3,3,3,1,1,1,1,1,9,9,9,0
1,5,5,5,5,5,5,5,5,5,5,8,3,8,5,1,1,1,1,0,1,1,1,2,1,1,2,2,3,2,2,1,1,1,1,9,9,9,9,1
1,1,5,6,5,5,6,5,5,6,5,8,3,3,3,3,3,3,3,3,3,3,3,3,3,3,3,3,3,2,1,1,1,1,9,9,9,9,1,0
1,1,5,5,0,6,5,5,5,5,5,8,8,8,0,0,0,0,0,0,1,2,2,2,2,2,2,2,2,2,0,1,1,9,9,9,9,0,1,0
1,1,5,1,1,6,6,6,6,6,6,1,0,0,0,0,0,0,0,0,1,2,2,2,2,2,2,2,2,1,0,1,9,9,9,9,9,1,1,0
9,9,9,9,1,1,6,6,6,1,1,0,0,0,0,0,0,0,0,2,2,2,2,2,2,2,0,0,0,0,1,1,9,9,9,9,1,0,0,1
9,9,9,9,1,1,1,5,2,2,2,2,1,1,1,1,2,2,2,2,2,2,2,2,2,2,0,1,1,1,1,9,9,9,9,9,1,0,0,1
9,9,9,9,1,1,1,2,2,1,1,2,2,2,2,2,2,1,1,2,2,2,2,2,2,2,1,1,0,0,9,9,9,9,9,9,0,1,0,1
1,1,1,9,9,9,1,1,1,1,1,1,1,1,1,1,1,0,0,2,2,2,2,2,0,1,1,1,1,1,9,9,9,9,1,0,0,1,1,0
9,1,1,9,9,9,9,9,1,1,1,0,1,1,0,0,1,1,1,1,1,1,1,1,1,1,1,0,0,0,1,1,0,1,1,1,1,1,1,0
