0,1,1,1,1,1,0,1,1,0,0,0,0,0,0,1,1,0,0,1,1,0,1,1,1,3,0,0,1,1,1,1,1,1,1,0,1,1,1,1,1,0,1,1,1,0,0,7,1,1,3,1,7,1,7,0,7,1,7,1,1,1,1,7,1,1,1,1,1,1,1,1,7,1,1,3,1,1,1,1,1,1,1,1,1,1,1,1,1,1,1,1,1,7,7,1,7,1,1,1
0,0,0,1,1,1,1,1,1,1,1,1,1,1,1,1,0,0,0,1,1,1,0,1,1,3,1,0,1,1,1,1,1,1,1,1,1,1,0,0,1,7,0,7,1,1,1,0,7,1,3,1,1,1,1,7,1,1,0,0,0,0,0,7,0,0,0,0,7,0,7,0,0,0,0,3,0,0,0,0,0,0,0,0,0,0,0,0,0,0,7,0,0,7,0,0,0,0,7,0
1,1,1,1,1,1,0,1,1,1,1,1,1,1,1,1,1,1,1,1,1,0,1,1,1,3,1,1,1,1,1,0,1,1,1,2,2,2,1,0,1,0,1,1,7,1,1,1,1,7,3,0,1,1,1,2,2,2,1,0,0,0,0,0,7,0,0,0,0,0,0,0,0,0,0,3,0,0,0,0,0,0,0,0,0,0,0,0,0,0,7,0,0,0,0,7,0,0,0,0
1,0,0,1,1,1,1,1,1,1,6,0,0,0,0,1,1,1,1,1,1,1,1,1,1,3,1,0,5,5,1,1,1,1,2,2,2,2,0,1,1,1,1,1,1,1,1,0,5,5,3,1,1,1,2,2,2,2,0,1,1,1,1,1,1,7,7,1,1,1,1,1,1,1,1,3,1,7,1,1,1,7,1,1,1,1,1,1,1,1,1,1,1,7,1,1,1,1,1,1
0,1,1,1,1,1,1,1,1,1,1,0,11,1,0,0,1,1,1,1,1,1,1,0,1,3,0,5,5,5,5,5,1,1,2,2,2,2,2,1,1,1,1,0,1,0,0,5,5,5,3,5,1,1,2,2,2,2,2,1,1,1,1,7,1,1,1,7,1,1,7,1,1,1,1,3,1,1,1,1,1,1,1,1,1,1,7,1,1,7,1,1,7,1,1,1,7,7,1,1
1,1,1,1,1,1,1,1,1,1,1,1,10,10,10,10,10,10,10,10,10,10,10,10,0,3,5,5,5,6,5,5,1,1,2,2,2,2,2,2,3,10,3,10,0,0,5,0,5,6,3,5,1,1,2,2,2,2,2,2,2,2,2,2,2,2,2,2,2,2,2,2,2,2,2,3,2,2,2,2,2,2,2,2,2,2,2,2,2,2,2,2,2,2,2,2,2,2,2,2
0,1,1,1,1,1,1,1,1,1,1,1,10,1,1,1,0,2,2,2,1,1,1,10,0,3,5,6,5,5,5,5,5,1,1,2,2,2,2,2,1,1,1,10,0,5,5,8,5,5,3,5,5,1,1,2,2,2,2,2,2,2,2,2,2,2,2,2,2,2,2,2,2,2,2,3,2,2,2,2,2,2,2,2,2,2,2,2,2,2,2,2,2,2,2,2,2,2,2,2
0,1,1,1,1,2,1,1,1,0,0,1,10,0,0,1,1,2,2,2,2,1,2,10,10,3,10,5,5,6,5,5,1,0,1,2,2,2,2,2,2,1,2,10,10,10,10,5,5,6,3,5,1,0,1,2,2,2,2,2,2,2,2,2,2,2,2,2,2,2,2,2,2,2,2,3,2,2,2,2,2,2,2,2,2,2,2,2,2,2,2,2,2,2,2,2,2,2,2,2
0,1,1,1,1,2,1,1,1,6,0,0,10,0,2,0,1,1,2,2,2,2,2,1,0,3,10,5,11,5,5,5,0,0,1,1,2,2,2,2,2,2,2,1,0,0,3,5,11,0,3,5,0,0,1,1,2,2,2,2,2,2,2,2,2,2,2,2,2,2,2,2,2,2,2,3,2,2,2,2,2,2,2,2,2,2,2,2,2,2,2,2,2,2,2,2,2,2,2,2
0,1,1,1,1,1,1,1,1,1,1,0,10,2,2,2,2,2,2,2,2,2,2,2,2,3,10,10,10,10,10,10,0,0,1,1,2,2,2,2,2,2,2,2,2,0,10,10,10,10,3,10,0,0,1,1,2,2,2,2,2,2,2,2,2,2,2,2,2,2,2,2,2,2,2,3,2,2,2,2,2,2,2,2,2,2,2,2,2,2,2,2,2,2,2,2,2,2,2,2
2,1,1,1,1,1,1,1,1,1,2,2,10,2,2,0,0,2,2,2,2,2,2,2,2,3,0,1,1,0,1,10,1,1,1,1,2,2,2,2,2,2,2,2,2,0,0,1,1,0,3,10,1,1,1,1,2,2,2,2,5,5,2,2,5,5,2,2,2,5,5,5,2,2,2,3,5,2,2,5,2,5,2,2,2,2,2,2,2,2,2,2,2,2,2,2,2,2,2,2
2,2,1,1,1,1,1,1,1,2,2,2,10,1,1,1,1,1,0,2,2,2,2,2,2,3,0,0,0,1,1,10,1,0,2,2,2,2,2,1,2,2,2,2,2,0,0,0,0,1,3,10,7,0,2,2,2,2,2,1,5,1,5,1,5,1,1,1,1,1,5,1,5,1,1,3,5,5,7,1,5,7,1,7,5,1,1,1,7,1,1,1,1,1,1,1,1,1,1,1
1,2,2,1,1,1,1,1,1,2,2,1,10,1,1,5,1,1,1,1,1,2,2,2,2,3,0,0,0,1,1,10,1,1,1,2,2,2,1,1,1,2,2,2,2,2,0,0,0,1,3,10,7,1,1,2,2,2,1,1,5,1,7,5,5,5,1,1,5,1,5,5,1,7,5,3,7,1,1,5,1,1,5,1,5,1,1,1,1,1,1,1,1,1,1,1,1,1,1,1
1,1,2,2,2,2,1,1,1,2,1,1,10,1,5,6,5,5,1,1,1,1,2,2,2,3,0,0,0,0,1,10,1,1,0,1,1,1,1,1,7,1,2,2,2,2,0,0,0,0,3,10,1,7,0,1,1,1,1,1,5,1,5,1,7,1,5,1,1,1,1,1,1,5,5,3,5,1,1,1,5,1,1,5,5,1,7,1,1,1,1,1,1,1,1,1,1,1,1,1
1,1,1,1,1,2,2,2,2,2,1,1,10,11,5,5,5,6,5,5,0,1,1,2,2,3,2,2,2,2,1,10,1,1,0,0,1,1,1,1,0,1,1,2,2,2,2,2,2,2,3,10,1,1,0,0,1,1,7,1,1,1,1,1,1,1,1,5,1,5,1,1,1,5,7,3,1,1,1,7,1,5,5,5,1,1,1,7,1,1,1,1,1,1,7,1,1,1,1,1
0,1,1,1,1,2,2,2,2,2,1,2,10,1,1,5,5,5,5,1,0,1,1,2,2,3,2,2,2,2,5,10,1,1,0,0,1,1,1,1,0,1,1,2,2,2,2,2,2,2,3,10,1,1,0,0,1,1,1,1,1,5,1,5,1,1,1,5,1,7,1,1,1,7,5,3,7,5,5,5,1,1,1,1,1,1,1,1,1,1,1,1,1,1,7,1,1,1,7,1
1,1,1,1,1,1,1,2,2,2,2,2,10,2,2,2,2,2,2,1,1,1,2,2,2,3,2,2,2,2,5,10,1,1,0,0,1,1,1,1,1,1,2,2,2,2,2,2,2,2,3,10,1,1,0,0,1,1,1,1,1,1,1,5,5,1,1,5,1,1,5,1,5,5,5,3,5,7,5,1,5,1,5,5,1,1,1,1,1,1,7,1,1,1,7,1,1,1,1,1
1,1,1,1,1,1,0,0,2,2,2,2,10,2,2,2,2,2,2,2,2,2,2,2,2,3,2,2,5,5,5,10,1,1,1,1,1,1,1,1,2,2,2,2,2,2,2,2,5,5,3,3,1,1,1,1,1,1,1,1,1,5,5,1,5,5,5,1,1,1,1,1,5,1,1,3,1,1,1,1,1,1,1,5,5,1,1,1,1,1,1,7,1,1,1,1,7,1,1,1
1,0,5,5,5,5,5,5,5,5,5,2,10,2,2,2,2,2,2,2,2,2,2,2,2,3,1,5,5,6,11,10,1,0,1,1,1,1,1,1,2,2,2,2,2,1,1,5,5,6,3,10,1,0,1,1,1,1,1,1,7,5,1,5,1,1,5,1,1,5,1,1,1,1,5,3,5,5,1,5,5,1,5,5,1,1,1,1,1,1,1,1,1,1,1,1,1,1,1,1
1,0,5,5,6,5,6,5,5,6,5,2,10,0,2,2,2,2,2,2,2,2,2,2,1,3,1,5,1,1,10,10,1,0,1,1,1,1,1,1,2,2,2,2,1,1,1,5,1,7,3,10,1,0,1,7,1,1,1,1,1,1,1,1,5,1,1,1,5,7,7,1,1,1,1,3,1,5,1,5,1,5,1,1,1,1,1,1,1,1,1,1,1,1,1,1,1,1,1,1
1,5,6,5,5,5,5,5,5,5,5,0,10,5,5,6,1,1,1,2,2,2,2,2,1,3,1,2,10,10,10,1,1,1,1,1,1,1,1,1,2,2,2,2,1,1,1,2,10,10,3,1,1,1,1,7,1,1,1,1,1,1,5,1,5,1,5,5,1,5,1,5,1,1,1,3,7,5,5,1,5,1,1,5,5,1,1,1,1,7,1,1,1,1,1,1,1,1,1,1
1,5,5,5,5,5,5,5,5,5,5,11,10,1,5,1,1,1,1,0,1,1,1,2,1,3,2,2,10,2,2,1,1,1,1,1,1,1,1,1,1,1,1,2,1,1,2,2,10,2,3,7,1,1,1,7,1,1,7,1,5,1,5,5,5,5,5,1,1,5,7,5,7,1,5,3,1,1,7,1,1,1,5,1,5,1,1,1,1,1,7,1,1,1,1,1,1,1,1,7
1,1,5,6,5,5,6,5,5,6,5,0,10,10,10,10,10,10,10,10,10,10,10,10,10,3,10,10,10,2,1,1,1,1,1,1,1,1,1,0,3,10,10,10,10,10,10,10,10,2,3,1,1,1,1,1,1,1,1,0,0,5,5,0,0,0,0,5,0,0,7,0,5,0,5,3,0,0,5,5,0,5,5,0,5,0,0,0,0,0,0,0,0,7,0,0,0,0,0,0
1,1,5,5,0,6,5,5,5,5,5,0,1,0,0,0,0,0,0,0,1,2,2,2,2,3,2,2,2,2,0,1,1,1,1,1,1,1,1,0,1,2,2,2,2,2,2,2,2,2,3,1,1,1,1,1,1,1,1,0,5,0,5,0,5,0,0,7,0,5,0,0,5,5,0,3,5,0,0,5,5,0,0,0,0,0,0,0,0,0,0,0,0,0,0,0,0,0,0,0
1,1,5,1,1,6,6,6,6,6,6,1,0,0,0,0,0,0,0,0,1,2,2,2,2,3,2,2,2,1,0,1,1,1,1,1,1,1,1,0,1,2,2,2,2,2,2,2,2,1,3,7,1,1,1,1,1,7,1,0,0,0,5,0,5,0,5,0,5,0,0,5,0,5,7,3,0,5,0,5,5,7,7,0,7,0,0,0,7,0,0,0,0,0,7,0,0,0,0,7
3,3,3,3,3,3,3,3,3,3,3,3,3,3,3,3,3,3,3,3,3,3,3,3,3,3,3,3,3,3,3,3,3,3,3,3,3,3,3,3,3,3,3,3,3,3,3,3,3,3,3,3,3,3,3,3,3,3,3,3,3,3,3,3,3,3,3,3,3,3,3,3,3,3,3,3,3,3,3,3,3,3,3,3,3,3,3,3,3,3,3,3,3,3,3,3,3,3,3,3
1,0,1,0,1,1,1,5,2,2,2,2,1,1,1,1,2,2,2,2,2,2,2,2,2,3,0,1,1,1,1,1,1,1,1,1,1,1,0,1,2,2,2,2,2,2,0,1,1,1,3,1,1,1,1,1,1,1,0,1,5,7,5,5,5,1,5,5,1,1,1,1,1,1,5,3,5,1,5,1,5,1,5,1,5,1,1,1,1,1,1,1,7,1,1,1,1,1,1,1
1,0,0,1,1,1,1,2,2,1,1,2,2,2,2,2,2,1,1,2,2,2,2,2,2,3,1,1,0,0,1,1,1,1,1,1,1,1,0,1,2,2,2,2,2,2,1,1,0,0,3,1,1,1,1,1,1,1,0,1,1,1,5,5,7,1,1,5,5,1,1,5,5,1,5,3,5,1,5,1,7,1,1,7,1,1,1,1,1,7,1,1,1,1,1,1,1,1,7,1
1,1,1,1,1,0,1,1,1,1,1,1,1,1,1,1,1,0,0,2,2,2,2,2,0,3,1,1,1,1,1,1,1,1,1,0,0,1,1,0,2,2,2,2,7,7,1,1,1,1,3,1,7,1,1,0,7,1,7,0,5,5,5,0,0,0,0,5,5,5,5,5,7,0,0,3,0,0,5,5,7,0,5,5,0,0,0,7,0,0,0,7,0,0,0,0,7,0,0,0
0,1,1,0,0,0,0,0,1,1,1,0,1,1,0,0,1,1,1,1,1,1,1,1,1,3,1,0,0,0,1,1,1,1,1,1,1,1,1,0,1,1,1,1,1,1,7,0,0,0,3,1,1,1,1,1,1,1,1,0,5,5,0,5,5,0,0,0,0,0,5,0,5,5,7,3,0,0,0,0,0,7,5,0,0,0,0,0,0,0,0,0,0,0,7,0,0,0,0,0
0,1,1,1,1,2,2,2,2,2,1,2,10,1,1,5,5,5,5,1,0,1,1,2,2,3,2,2,2,2,5,3,7,1,0,0,1,1,1,1,2,1,2,2,1,2,0,1,10,10,3,1,1,2,2,1,0,2,1,2,5,1,5,1,1,2,5,10,5,10,5,2,5,0,5,3,2,5,1,0,1,1,2,5,5,0,5,1,11,1,2,1,10,1,1,1,1,6,1,2
1,1,1,1,1,1,1,2,2,2,2,2,10,2,2,2,2,2,2,7,7,7,2,2,2,3,2,2,2,2,5,3,1,1,0,0,7,1,1,1,1,6,0,1,0,2,2,1,1,6,3,1,1,0,10,2,0,6,2,0,0,10,5,1,1,5,5,1,1,5,5,5,5,1,5,3,5,1,1,0,1,0,5,0,2,1,0,2,5,2,1,2,2,2,2,2,5,2,2,1
1,1,1,1,1,1,0,0,2,2,2,2,10,2,2,2,2,2,2,2,2,2,2,2,2,3,2,2,5,5,5,10,1,1,7,1,1,1,1,1,1,2,5,2,1,6,1,5,1,1,3,1,2,1,1,5,10,0,0,2,1,5,2,1,5,5,5,1,1,0,5,5,5,2,5,3,2,5,2,5,0,5,2,2,2,2,1,2,5,1,5,10,1,1,1,1,0,0,1,1
7,0,5,5,5,5,5,5,5,5,5,2,10,2,2,2,2,2,2,2,2,2,2,2,2,3,1,5,5,6,11,10,1,0,1,1,1,1,1,1,2,1,2,2,0,5,2,1,1,0,3,1,2,1,10,2,1,1,0,5,5,5,0,2,5,1,5,5,1,5,0,10,1,5,0,3,0,5,1,5,1,5,5,5,5,2,6,1,0,1,1,1,1,5,1,0,1,6,10,10
1,0,0,5,6,0,6,5,5,6,5,2,10,0,2,2,2,2,2,2,2,2,2,2,1,3,1,5,1,1,10,10,1,0,1,1,1,1,1,1,1,0,1,1,0,0,1,1,1,6,3,5,1,1,0,1,2,2,1,1,5,10,5,5,5,5,2,5,5,5,5,5,1,2,2,3,5,2,1,5,1,5,5,5,5,1,0,1,1,1,2,0,1,1,2,10,1,5,2,2
1,5,6,5,5,5,5,5,5,5,5,0,10,5,5,6,1,1,1,2,2,2,2,2,1,3,1,2,10,10,10,1,1,1,1,1,1,1,1,7,5,2,2,2,5,1,1,1,1,1,3,0,1,2,1,10,0,2,10,1,0,5,1,1,2,1,0,5,5,1,2,1,5,5,1,3,5,0,5,1,5,1,2,5,1,1,1,2,2,10,1,5,2,10,1,1,2,1,1,5
1,5,5,0,0,5,5,5,5,5,5,6,10,1,5,1,1,1,1,0,1,1,7,2,1,3,2,2,10,2,2,1,1,1,1,1,1,1,7,1,10,2,2,2,0,2,2,1,0,10,3,10,6,2,0,0,1,1,5,1,5,5,5,1,0,5,1,1,0,1,5,1,5,1,5,3,5,1,2,5,2,1,5,1,10,1,2,1,5,11,11,5,1,2,6,2,5,1,1,0
1,1,0,6,5,5,6,5,5,6,5,0,10,10,10,10,10,10,10,10,10,10,3,10,10,3,3,10,10,2,1,1,1,1,1,1,1,1,1,0,1,1,2,10,2,10,1,0,2,1,3,2,1,1,5,1,1,6,1,2,5,5,5,1,5,5,6,5,5,5,0,5,5,5,1,3,5,5,5,1,1,2,2,1,1,6,2,2,0,2,2,1,1,1,1,0,2,2,10,1
1,1,5,5,0,6,5,5,5,5,5,0,1,0,0,0,0,0,0,0,1,2,2,2,2,3,2,2,2,2,0,1,1,1,1,1,7,1,1,0,2,1,0,1,5,1,0,5,1,1,3,1,1,1,1,2,0,2,2,10,10,5,5,1,5,0,5,5,1,1,0,5,1,5,5,3,5,5,5,5,2,1,5,2,1,1,2,6,0,10,5,1,1,1,2,1,1,1,1,0
1,1,5,1,1,6,6,6,6,6,6,1,7,0,0,0,0,0,0,0,1,2,2,2,2,3,2,2,2,1,0,1,1,1,1,1,1,1,1,0,1,1,2,0,1,0,2,5,5,0,3,2,1,1,1,2,0,10,0,1,2,5,1,5,1,5,0,1,1,2,2,5,1,1,5,3,5,5,5,5,0,5,0,2,5,1,1,0,2,1,0,1,1,1,1,1,10,2,10,1
1,0,0,0,1,1,6,8,6,1,1,0,0,0,0,0,0,0,0,2,2,2,2,2,2,3,0,0,0,0,1,1,7,1,1,1,7,0,0,7,10,2,2,1,0,2,1,10,1,1,3,1,1,1,1,1,0,1,1,2,1,10,2,1,1,1,2,2,1,2,5,2,5,1,1,3,1,5,1,1,1,11,2,0,1,1,5,10,1,1,10,2,1,1,1,5,2,6,2,10
7,0,7,7,1,7,1,5,2,2,2,2,1,1,1,1,2,2,2,2,2,2,2,2,2,3,0,1,1,7,1,1,7,1,1,1,1,1,0,1,1,1,0,10,1,10,5,10,1,10,3,2,1,5,1,1,1,1,0,1,2,1,0,1,2,1,2,1,2,1,1,1,1,1,1,3,2,2,1,1,5,1,2,6,1,5,1,2,2,1,0,1,1,1,1,0,2,1,2,1
1,0,0,1,1,1,1,2,2,1,1,2,2,2,2,2,2,1,7,2,2,2,2,2,2,3,1,1,0,7,1,1,1,1,1,1,1,1,0,1,0,2,1,2,1,0,1,1,0,1,3,0,1,2,1,1,1,5,1,1,1,0,2,1,2,1,0,10,1,1,5,2,1,1,1,3,1,0,1,2,10,2,2,1,1,5,1,0,1,1,1,1,2,1,1,1,5,0,1,1
1,1,7,1,1,0,1,1,1,1,1,1,1,1,1,7,1,0,0,2,2,2,2,2,0,3,1,1,1,1,1,1,7,1,1,0,0,1,1,0,0,5,1,6,10,1,1,0,10,1,3,2,1,1,1,2,1,1,6,1,0,1,1,1,0,10,6,1,1,1,0,1,1,1,1,3,1,1,1,1,1,1,0,0,1,1,6,2,1,0,2,2,1,1,5,5,0,0,2,2
0,1,1,0,0,0,0,0,1,1,1,0,1,1,0,0,7,1,1,1,1,1,1,1,1,3,7,0,0,0,1,1,7,1,1,7,1,1,1,0,1,5,6,1,2,1,2,2,0,0,3,1,0,10,0,1,1,1,1,0,1,2,1,1,1,1,1,2,1,10,5,2,0,1,1,3,0,2,5,1,1,0,6,10,5,2,5,1,1,1,1,0,2,1,0,2,0,2,5,1
7,7,1,0,0,0,0,7,1,1,1,0,1,1,0,0,1,1,1,1,1,1,1,1,1,3,1,0,0,0,7,1,1,1,1,7,1,1,1,0,6,2,1,2,5,1,2,5,6,5,3,5,1,1,1,1,0,1,1,10,1,1,1,1,2,1,1,1,1,2,2,6,2,1,2,3,1,10,1,1,1,0,1,1,0,1,1,1,1,6,2,2,1,0,5,10,1,2,5,0
0,1,7,7,0,0,0,7,1,1,1,0,1,1,0,0,1,1,1,1,7,1,1,1,1,3,1,0,0,0,1,1,7,1,1,7,1,1,1,0,2,2,2,1,1,1,1,0,0,1,3,1,2,1,2,2,1,2,1,1,1,1,1,1,1,1,1,1,1,1,1,1,1,1,1,3,2,2,0,0,10,0,2,10,0,2,0,0,2,2,0,1,0,5,1,2,1,1,1,1
7,1,1,0,0,0,0,0,1,1,1,7,1,1,0,0,1,1,1,1,1,1,1,1,1,3,1,0,0,7,1,1,1,1,1,7,1,1,1,0,1,1,1,5,1,1,2,0,1,1,3,5,5,1,2,5,1,5,1,1,1,5,1,1,1,1,1,10,2,1,5,1,1,10,0,3,10,1,10,5,5,1,2,1,0,6,1,1,0,1,1,1,1,1,1,2,1,2,1,1
0,1,1,7,0,0,0,7,1,1,1,0,1,1,0,0,1,1,1,1,7,1,1,1,1,3,1,0,0,0,7,1,1,1,1,7,1,1,1,7,0,1,11,1,0,2,2,2,1,1,3,1,1,1,5,1,5,10,2,1,2,0,0,1,2,5,6,1,1,1,1,1,2,1,1,3,2,2,2,1,1,1,1,1,1,2,1,1,2,2,2,2,0,10,5,1,0,1,1,2
0,1,1,0,0,0,0,7,1,1,1,0,1,1,0,0,1,1,1,1,1,1,1,1,1,3,1,0,0,0,1,1,1,1,1,1,1,1,1,0,1,0,2,2,1,1,1,1,1,10,3,1,1,2,1,1,2,1,1,1,1,5,2,1,2,1,1,1,0,2,1,2,1,2,2,3,2,0,0,5,1,0,1,0,0,1,1,2,1,1,5,1,1,1,1,1,1,2,2,5
3,3,3,3,3,3,3,3,3,3,3,3,3,3,3,3,3,3,3,3,3,3,3,3,3,3,3,3,3,3,3,3,3,3,3,3,3,3,3,3,3,3,3,3,3,3,3,3,3,3,3,3,3,3,3,3,3,3,3,3,3,3,3,3,3,3,3,3,3,3,3,3,3,3,3,3,3,3,3,3,3,3,3,3,3,3,3,3,3,3,3,3,3,3,3,3,3,3,3,3
0,1,1,0,0,0,0,0,1,1,1,0,1,1,0,0,5,1,1,1,5,1,1,5,5,3,1,0,0,0,1,1,1,1,1,1,1,1,5,0,1,2,0,1,0,0,2,5,0,2,3,2,1,1,1,1,1,1,2,1,2,1,2,1,6,1,1,1,2,2,1,1,1,5,2,3,5,1,2,1,1,0,6,1,1,1,1,1,0,1,2,2,2,1,0,2,1,0,1,1
0,1,1,0,0,0,0,0,1,7,1,5,1,1,5,5,5,1,1,1,1,5,5,5,1,3,5,0,7,5,1,1,1,5,1,1,5,1,5,0,0,1,1,5,10,2,1,1,1,2,3,1,1,0,1,2,1,0,1,1,1,1,1,2,1,1,1,10,10,1,1,1,2,1,1,3,1,2,2,2,1,1,1,2,2,1,1,1,1,1,2,1,0,1,1,1,1,10,0,10
0,1,1,0,0,0,0,0,1,1,5,0,1,5,0,0,1,1,1,1,1,1,1,1,1,3,1,5,0,0,1,1,1,7,1,5,7,7,1,0,1,1,10,1,0,1,1,2,10,2,3,1,10,6,1,1,1,1,1,1,1,1,2,1,1,1,1,5,1,10,1,1,1,0,2,3,2,2,1,2,5,1,1,1,2,10,2,2,2,1,5,2,1,10,0,0,5,0,5,1
0,1,1,7,0,7,0,0,1,1,5,5,7,1,5,5,1,1,1,1,5,1,1,5,1,3,1,5,0,0,5,5,5,7,5,1,7,7,1,5,1,1,1,1,5,1,2,1,1,2,3,2,10,0,5,1,1,1,1,0,1,2,1,1,10,1,2,1,0,1,1,0,1,2,0,3,2,1,5,0,5,1,1,0,1,2,5,10,1,1,1,1,1,1,5,10,2,1,1,1
0,1,1,0,0,0,0,7,1,7,1,0,1,5,0,0,5,5,5,5,1,1,5,1,1,3,5,0,0,0,5,1,1,1,1,1,1,5,5,0,2,10,1,0,1,5,1,5,1,0,3,1,2,1,0,1,1,1,1,1,1,1,1,1,1,1,1,1,1,5,1,1,1,1,2,3,1,5,0,0,0,2,5,1,1,0,1,2,5,1,0,1,2,5,2,1,10,5,1,10
0,1,7,0,0,0,0,7,1,1,1,5,7,1,0,0,1,7,1,5,1,1,1,1,1,3,5,0,0,5,1,1,1,1,1,5,5,5,1,0,1,1,5,2,5,2,1,1,6,1,3,1,2,1,2,1,1,1,1,0,1,1,1,1,1,1,0,1,1,10,2,10,2,2,6,3,5,5,0,1,2,5,0,2,1,11,0,1,1,0,1,1,0,1,5,2,1,1,1,1
0,1,1,0,0,0,0,7,7,1,1,5,1,5,0,5,1,5,1,1,1,1,1,7,1,3,5,0,0,5,1,5,1,1,1,1,1,5,1,0,2,1,1,0,5,1,1,2,1,1,3,1,1,2,1,1,1,1,2,2,2,1,1,2,1,6,2,1,0,5,2,0,1,2,2,3,1,2,1,2,2,1,2,1,0,0,2,2,5,1,1,10,0,1,1,0,10,2,0,2
7,1,1,0,0,0,0,0,1,7,1,0,1,1,0,5,7,1,1,1,5,1,1,5,7,3,7,0,5,5,1,5,1,7,1,1,1,1,5,5,1,0,2,11,10,2,2,1,1,2,3,1,1,2,5,2,1,2,10,1,1,1,11,1,1,1,10,1,1,0,0,1,2,1,0,3,2,1,0,5,0,1,1,0,1,1,1,2,0,0,0,1,1,1,2,1,0,1,1,10
0,7,1,0,0,0,0,0,7,1,7,0,1,5,7,0,1,7,1,1,1,1,1,1,5,3,1,0,5,0,5,7,5,5,7,5,1,1,1,0,1,1,1,2,2,2,1,10,2,2,3,1,1,1,1,1,1,5,1,6,1,1,0,2,5,10,1,1,1,1,1,1,2,10,1,3,1,1,0,2,10,5,2,2,0,1,0,5,2,1,2,10,1,0,10,0,1,5,0,0
0,1,1,0,0,0,7,0,1,1,1,0,1,1,0,0,1,1,1,5,5,7,1,1,1,3,1,0,5,5,1,5,1,5,1,1,7,5,5,5,1,1,1,2,2,1,10,1,1,5,3,0,0,1,1,1,5,0,1,1,2,1,2,0,1,1,10,1,1,2,2,0,1,5,0,3,5,2,6,5,2,2,0,1,2,1,2,2,1,1,2,2,2,2,1,2,0,2,1,1
0,7,1,0,0,0,0,0,1,1,5,5,1,1,5,5,5,5,5,1,1,1,1,1,1,3,1,0,0,0,1,5,5,5,1,5,1,1,1,0,1,1,2,1,2,0,1,2,2,0,3,1,1,0,0,5,1,2,1,6,2,1,2,11,1,1,2,10,1,1,1,2,5,5,2,3,0,1,1,0,1,1,2,1,0,2,1,5,6,2,0,10,1,2,1,1,5,2,1,1
0,1,1,0,0,0,0,0,1,1,5,5,5,1,5,0,5,1,1,1,1,1,1,5,5,3,1,0,5,7,1,1,1,5,1,1,5,5,1,0,0,1,10,2,2,0,0,1,1,0,3,1,2,6,10,0,1,1,1,5,2,1,1,0,1,1,0,2,2,0,0,1,1,0,2,3,1,2,10,1,5,1,2,5,2,2,1,1,5,1,2,1,10,5,1,1,10,1,0,0
0,1,1,7,0,0,7,0,1,1,1,0,1,1,7,0,1,1,5,1,7,1,5,7,7,3,1,5,0,0,5,1,5,5,1,5,5,7,1,0,6,1,2,2,1,5,1,2,0,1,3,2,1,0,5,5,0,0,2,1,10,1,10,1,1,1,0,2,1,2,1,2,1,1,10,3,2,5,1,1,1,2,0,2,1,2,2,10,0,6,1,1,5,0,2,1,10,5,2,1
0,1,1,7,0,0,7,0,1,7,5,0,5,1,0,0,7,5,5,1,1,1,1,1,1,3,1,5,0,5,1,1,1,1,7,5,1,5,1,5,1,5,0,1,2,1,1,1,2,2,3,2,1,10,2,10,5,0,1,1,10,0,5,1,10,0,1,2,1,0,2,1,1,1,1,3,10,2,10,10,1,1,0,2,1,0,1,1,5,1,0,1,2,0,2,0,1,1,0,1
0,1,1,0,0,7,0,0,1,7,5,0,1,5,0,0,1,5,5,1,1,1,1,1,7,3,1,7,5,0,7,1,1,5,1,5,7,1,5,0,1,0,1,2,0,2,0,2,1,11,3,1,1,1,2,6,2,1,1,1,1,0,2,2,2,0,0,2,1,1,0,0,2,5,1,3,1,0,2,2,1,0,0,1,0,5,5,1,2,5,2,10,2,1,1,5,1,2,2,5
0,1,1,7,0,0,0,0,1,1,5,0,5,1,5,5,1,5,5,1,1,7,5,1,1,3,1,0,0,0,1,1,1,5,1,5,5,1,1,5,1,5,5,2,1,5,1,1,1,6,3,1,2,1,1,1,5,0,2,1,1,10,2,2,1,2,1,1,0,5,1,2,1,0,1,3,2,2,5,2,1,1,2,1,0,1,0,1,1,1,0,1,1,2,1,2,0,1,5,0
0,1,1,0,0,0,0,7,1,1,1,0,7,5,7,5,1,1,1,1,1,1,7,5,1,3,1,5,0,0,1,5,5,5,1,7,1,1,5,5,1,1,0,1,6,1,2,5,5,1,3,1,2,2,2,1,1,10,5,1,1,1,0,1,0,2,1,0,2,1,10,0,1,1,2,3,2,2,1,1,0,2,0,2,6,1,1,0,2,0,0,5,0,2,1,0,1,1,2,2
0,7,1,0,0,0,0,0,1,1,1,0,5,5,0,5,1,5,1,1,1,1,1,5,1,3,1,0,0,5,1,1,5,1,1,1,1,5,5,0,10,0,2,2,2,2,1,2,2,2,3,5,1,1,1,2,10,2,1,2,1,1,1,1,2,0,1,1,10,2,6,2,2,1,2,3,2,2,2,0,0,1,2,10,1,0,0,2,1,2,1,1,1,1,5,2,1,2,1,1
0,1,1,0,0,0,0,0,1,7,5,5,1,1,0,0,1,5,5,1,7,1,1,1,1,3,1,0,0,0,1,5,5,5,5,1,1,1,5,0,2,1,0,1,1,1,1,1,1,1,3,1,5,2,0,1,1,2,2,2,1,5,5,1,0,2,1,0,1,1,0,2,1,1,1,3,1,0,1,1,1,5,1,1,1,1,2,1,0,2,1,1,2,2,1,0,1,0,1,2
0,1,1,0,0,0,7,0,1,1,1,0,5,5,5,0,5,7,5,1,1,5,1,5,5,3,1,0,0,0,1,1,5,5,1,5,5,7,7,0,2,0,1,5,10,1,0,1,1,1,3,1,10,1,5,1,5,2,2,2,0,2,0,2,0,2,2,1,1,1,1,1,1,1,1,3,1,1,1,1,2,1,6,1,1,1,1,1,1,1,1,1,1,2,1,2,1,1,1,1
0,1,1,0,0,7,0,0,1,7,1,0,1,1,0,5,7,1,1,5,1,5,1,1,1,3,1,0,0,0,1,5,1,5,7,1,5,5,7,5,1,1,1,10,2,10,2,5,1,1,3,2,1,1,2,2,1,10,5,0,1,0,1,2,0,2,1,0,1,2,1,1,1,1,1,3,1,2,1,1,1,1,1,1,1,1,1,1,2,1,1,1,2,1,5,1,1,2,1,5
0,1,1,0,0,0,0,0,1,1,1,0,1,1,0,0,1,1,1,1,1,5,1,1,1,3,1,5,0,0,5,1,1,1,1,1,5,5,1,0,10,5,1,1,1,5,1,1,2,0,3,2,2,0,2,1,1,1,1,2,0,2,0,10,0,5,5,2,10,2,1,1,1,1,1,3,1,1,1,1,1,2,1,1,1,1,1,1,1,1,1,1,1,2,1,1,1,1,10,1
0,1,1,0,0,0,0,0,1,1,5,0,1,1,5,0,1,1,1,1,1,1,1,5,1,3,1,5,0,5,1,7,1,5,1,5,5,1,1,0,1,0,2,2,2,2,2,1,0,10,3,1,1,0,0,1,1,1,1,1,1,1,1,5,1,1,6,1,1,1,1,1,1,1,1,3,1,2,2,1,1,1,1,1,1,1,1,1,1,1,1,1,1,1,10,5,1,10,0,0
7,1,1,0,0,0,0,0,1,1,1,0,7,5,5,0,5,5,1,1,1,5,5,1,7,3,5,7,0,0,5,1,1,1,1,5,5,1,1,0,2,1,2,2,10,0,2,1,2,2,3,0,5,1,10,1,5,1,0,1,5,1,1,2,2,10,2,2,2,0,1,1,10,1,1,3,10,1,1,1,1,0,1,1,1,1,1,1,1,1,1,1,1,1,1,10,1,1,1,2
3,3,3,3,3,3,3,3,3,3,3,3,3,3,3,3,3,3,3,3,3,3,3,3,3,3,3,3,3,3,3,3,3,3,3,3,3,3,3,3,3,3,3,3,3,3,3,3,3,3,3,3,3,3,3,3,3,3,3,3,3,3,3,3,3,3,3,3,3,3,3,3,3,3,3,3,3,3,3,3,3,3,3,3,3,3,3,3,3,3,3,3,3,3,3,3,3,3,3,3
7,1,1,0,0,0,0,0,1,1,1,5,1,5,5,0,5,1,7,1,1,1,5,5,1,3,1,7,7,0,1,5,5,1,1,1,5,1,7,0,2,10,1,2,2,1,1,0,2,5,3,0,0,2,1,1,0,1,5,1,1,1,0,0,10,1,5,1,1,10,1,2,1,1,1,3,1,1,1,2,1,1,1,1,1,1,1,1,2,1,1,1,1,1,1,0,0,2,0,0
0,1,1,0,0,7,0,0,1,1,1,0,5,5,0,0,1,5,1,5,5,1,1,1,1,3,1,0,0,5,1,1,7,5,1,1,5,1,1,7,2,2,2,1,10,1,2,2,1,1,3,1,1,1,5,5,5,2,2,1,2,1,1,1,2,1,0,0,2,0,1,1,1,1,1,3,1,1,1,1,1,1,1,1,1,2,1,1,1,1,1,1,1,1,2,2,0,1,1,11
0,1,1,7,0,0,0,0,7,1,1,7,1,1,0,5,5,1,1,1,1,5,1,5,7,3,5,5,0,0,1,5,1,7,1,1,1,1,1,0,10,0,1,2,5,2,2,1,2,1,3,5,2,1,6,5,1,1,0,2,1,1,5,0,0,1,2,1,2,1,1,1,1,11,1,3,1,1,1,1,1,2,1,1,1,1,1,1,1,1,1,1,1,1,1,10,10,0,2,1
0,1,1,0,0,0,0,0,1,1,1,0,5,5,5,5,1,1,1,5,1,1,1,5,1,3,1,0,0,0,1,5,7,7,1,1,1,1,1,5,0,1,1,1,2,10,1,1,1,10,3,1,1,2,1,2,2,0,0,2,1,1,1,2,1,5,0,1,2,5,1,2,1,1,1,3,6,1,1,5,1,1,1,1,1,1,1,1,1,1,1,1,1,1,1,10,1,1,2,1
7,7,7,0,0,0,0,0,1,7,1,0,1,1,0,0,1,1,1,1,1,1,2,1,1,3,1,0,0,0,1,1,1,1,1,7,1,1,1,0,2,10,1,10,1,1,6,1,2,2,3,2,5,0,1,0,1,2,10,1,1,1,2,1,1,0,2,2,1,0,1,1,1,1,1,3,0,1,1,1,5,1,1,1,1,1,1,1,1,1,1,1,1,1,1,1,10,5,2,10
0,1,1,0,0,0,0,0,1,1,1,0,1,1,0,0,1,1,1,1,1,1,1,1,1,3,1,0,0,7,1,1,1,1,1,1,1,2,1,7,0,1,1,1,1,2,1,1,2,2,3,1,2,1,1,1,2,1,2,5,10,5,1,10,1,2,10,10,0,1,1,0,2,1,1,3,1,1,1,1,1,1,1,1,1,1,1,1,1,1,1,1,1,1,1,1,1,10,2,1
0,1,1,0,0,0,0,0,1,7,1,0,1,1,0,0,1,1,1,1,1,1,1,1,1,3,7,0,0,7,1,1,1,1,1,1,7,2,1,0,1,0,1,10,0,2,0,0,1,1,3,1,1,1,5,1,2,5,1,2,1,10,10,1,1,2,2,2,2,1,2,1,2,1,1,3,1,1,2,1,1,0,1,1,2,1,0,1,1,1,1,1,1,1,1,10,5,5,1,10
0,1,1,0,0,0,0,0,1,1,1,0,1,1,0,0,1,1,1,1,1,1,1,1,1,3,1,0,0,0,1,1,1,2,1,1,1,1,1,2,5,2,0,2,1,1,2,1,1,5,3,1,1,5,0,1,2,2,1,2,1,2,1,2,1,5,0,5,5,0,1,1,1,2,1,3,1,1,1,1,1,1,1,1,1,1,1,1,1,1,1,1,1,1,1,1,2,1,0,0
0,1,1,0,0,7,0,0,1,1,1,0,1,1,7,0,1,1,1,1,1,1,1,1,2,3,1,0,0,0,1,1,1,1,1,1,7,1,2,0,1,1,1,5,2,10,1,1,1,1,3,1,1,2,1,2,2,1,1,2,1,2,1,2,2,5,0,10,0,2,1,1,1,2,1,3,1,2,1,1,10,1,1,1,2,1,1,1,1,1,1,1,1,1,1,0,2,1,2,2
7,1,1,0,0,0,7,0,1,7,1,0,1,1,0,0,7,1,1,1,1,7,1,1,1,3,2,7,2,2,1,1,2,1,1,1,1,7,2,0,2,1,1,2,1,0,5,1,1,1,3,2,1,1,1,1,10,2,1,5,2,2,1,1,0,1,1,2,2,5,1,1,1,1,1,3,1,2,1,2,1,1,1,1,1,1,1,1,0,1,1,1,1,1,1,1,2,1,1,1
0,1,1,0,0,7,0,0,1,7,1,0,1,1,0,7,1,1,1,1,1,2,1,7,1,3,1,0,2,2,1,2,1,1,1,1,2,1,1,0,2,1,1,10,1,2,5,1,1,1,3,2,1,1,0,2,5,2,2,0,2,10,10,0,0,10,1,2,2,2,1,1,1,1,1,3,2,1,1,1,1,1,1,1,1,1,1,1,1,1,1,1,1,1,1,0,1,1,2,2
0,1,1,0,7,0,0,0,1,1,1,0,7,1,0,0,1,1,1,1,2,1,1,1,7,3,1,2,0,0,2,2,1,1,2,1,2,1,1,0,0,2,1,2,5,2,5,1,1,5,3,5,1,0,10,1,2,1,1,6,5,11,1,1,1,5,1,1,1,1,1,2,1,1,1,3,1,1,1,2,1,0,1,1,1,1,1,1,1,1,1,1,1,1,1,1,2,1,5,0
0,1,7,7,0,0,0,0,1,1,7,0,1,1,7,0,1,1,1,1,2,1,1,1,1,3,7,2,0,0,2,1,1,1,2,1,1,1,1,0,1,2,1,0,5,10,2,2,10,1,3,2,1,0,2,5,0,1,2,1,0,6,1,1,2,1,5,5,1,2,1,1,0,5,1,3,1,1,1,1,1,1,1,1,2,1,1,1,1,2,1,1,1,1,2,5,5,6,0,2
0,1,7,0,0,0,0,7,7,1,1,0,1,7,0,0,1,1,1,1,1,1,1,2,1,3,1,0,0,0,1,1,1,1,1,2,1,1,1,0,0,1,2,2,2,2,0,5,2,2,3,2,5,2,2,5,1,1,2,1,1,2,2,2,2,1,10,2,5,2,1,1,1,1,2,3,1,1,1,1,1,1,1,2,1,1,1,1,1,1,1,1,1,1,1,2,1,1,2,1
0,1,7,0,0,0,0,0,1,7,1,0,1,1,7,0,1,1,7,1,1,1,1,2,1,3,1,0,0,0,1,1,1,7,1,2,1,1,1,0,10,1,2,1,2,2,1,2,2,2,3,1,0,0,5,2,6,1,5,2,2,2,1,2,2,2,1,1,1,2,1,1,1,2,2,3,10,1,0,2,10,2,0,5,0,2,1,1,5,0,10,1,0,1,1,5,5,0,10,10
0,1,1,0,0,0,0,0,1,7,1,0,1,1,0,0,7,1,1,1,1,1,1,1,1,3,1,0,0,0,1,1,1,1,1,1,7,1,1,0,1,5,1,0,1,2,5,1,2,1,3,0,1,2,2,0,2,2,0,1,1,1,0,1,1,5,1,1,1,0,1,1,2,5,0,3,1,2,1,5,1,1,1,1,0,6,1,10,1,1,10,2,6,2,1,2,1,1,1,1
0,7,7,0,0,0,0,0,1,7,1,0,1,1,7,0,1,1,7,1,1,1,1,1,7,3,1,0,0,0,1,1,1,1,1,1,1,7,1,0,2,2,11,1,1,0,5,0,1,5,3,0,6,0,1,1,0,2,6,1,2,5,0,1,2,2,2,2,2,1,1,2,1,2,2,3,11,1,5,0,2,1,1,2,2,5,1,0,10,6,1,1,2,2,1,1,1,2,1,10
7,1,1,0,0,0,0,7,1,7,7,0,1,1,0,0,1,1,1,1,1,1,1,1,1,3,1,0,0,7,7,1,1,1,1,1,1,7,1,0,5,2,1,1,2,2,0,1,1,2,3,1,2,2,5,5,10,1,5,2,0,0,0,2,2,1,2,1,1,2,2,1,0,6,1,3,2,1,2,10,1,2,1,1,2,1,2,1,0,2,0,1,10,1,2,1,2,1,0,1
0,1,1,0,0,7,0,0,1,1,1,0,1,1,0,0,1,1,1,7,7,7,1,1,1,3,1,0,7,0,7,1,1,1,1,1,1,1,1,0,1,5,1,5,1,1,1,1,1,2,3,1,2,2,5,2,1,1,1,1,1,1,2,2,0,2,1,5,1,1,0,5,1,0,1,3,1,10,1,2,2,1,2,1,1,0,1,1,1,6,1,1,1,1,1,1,1,1,1,1
0,1,7,0,0,0,0,0,1,1,1,7,1,1,0,0,7,1,7,1,7,7,1,1,7,3,1,0,0,0,7,1,1,1,1,1,1,1,1,0,1,0,1,1,1,1,1,1,1,1,3,1,2,1,2,0,0,10,1,1,2,1,1,1,6,0,1,1,2,1,5,1,5,1,2,3,1,1,0,2,1,0,1,1,1,2,2,1,1,5,1,5,2,0,0,1,1,0,5,0
0,7,1,0,0,0,0,0,1,1,1,0,1,1,0,0,1,1,1,1,1,1,1,1,1,3,1,0,0,0,1,1,7,1,1,1,1,1,1,7,1,2,1,1,2,2,2,1,10,2,3,10,2,1,2,1,2,10,1,1,1,1,1,1,5,0,11,2,1,1,2,2,1,1,1,3,1,0,2,11,1,2,1,2,10,1,1,0,0,2,1,0,1,2,2,1,10,1,2,0
0,1,1,7,0,0,0,0,1,1,1,0,1,1,7,0,1,1,1,1,1,1,1,1,1,3,1,0,0,0,1,1,1,1,1,1,1,1,1,0,1,10,0,1,1,2,0,1,0,1,3,2,1,6,1,10,0,5,0,1,1,1,2,1,1,1,0,1,0,1,1,1,1,2,1,3,1,1,5,1,1,1,2,2,1,10,2,2,1,2,1,1,2,2,1,1,2,1,0,1
0,1,1,7,0,0,0,0,1,1,1,0,1,1,0,0,1,7,1,1,7,1,7,1,1,3,7,7,0,0,1,1,1,1,1,1,1,1,1,0,10,1,2,2,10,2,1,0,1,1,3,10,1,2,2,2,1,2,0,1,2,1,5,2,0,1,1,1,2,10,1,2,1,1,0,3,2,1,2,2,5,1,2,0,1,1,2,5,0,1,2,0,1,0,1,5,0,1,5,1
0,1,1,0,0,0,0,0,1,1,1,0,1,1,0,0,1,1,1,1,1,1,7,1,1,3,1,0,0,0,1,7,1,1,1,1,1,1,1,0,1,2,1,1,2,1,1,1,1,10,3,1,10,1,1,5,0,0,2,0,1,5,1,10,1,5,1,1,1,1,1,1,0,0,1,3,2,0,1,5,11,1,10,2,10,5,0,1,1,2,1,0,1,1,0,0,1,0,2,6
